bbbbrrookk
oopgrrorrk
oppggyorrk
op  gyy  #
#    y   #
#        #
#        #
#        #
#        #
#        #
#        #
#        #
#        #
#        #
#        #
#        #
#        #
##########
